4

3 3
###
#.#
###
7 6
#######
#.#.###
#.#.###
#.#.#.#
#.....#
#######
5 5
##.##
##.##
.....
##.##
##.##
3 4
###
#.#
#.#
###

